 "(" 0 -1 1 ")" "SEA" 
 "(" 1 0 -1 ")" "SEA" 
 "(" 1 -1 0 ")" "SEA" 
 "(" 0 0 0 ")" "SEA" 
 "(" 0 1 -1 ")" "SEA" 
 "(" -1 0 1 ")" "SEA" 
